############
#. . . . R.#
# @ .gr . .#
#. . . . G.#
############