
 #######
 #     #
 #  @  #
 ##rrr##
  #   #
  ## ###
   # bB#
   #####