....####
#####..#
#...B..#
#..X#..#
##.##.##
#......#
#.@#...#
#..#####
####