 #####
 #...####
 #...#..#
 ##....W#
###.###W#
#.w.# #W#
#.ww# ###
#@..#    
#####